#######################################
# Syntax Coloring Map For OneSheeld
#######################################

#######################################
# Datatypes (KEYWORD3)
#######################################
AccelerometerSensor	KEYWORD3
Buzzer	KEYWORD3
Camera	KEYWORD3
Email	KEYWORD3
Facebook	KEYWORD3
FlashLight	KEYWORD3
Foursquare	KEYWORD3
GamePad	KEYWORD3
GPS	KEYWORD3
GravitySensor	KEYWORD3
GyroscopeSensor	KEYWORD3
Keypad	KEYWORD3
LCD	KEYWORD3
LED	KEYWORD3
LightSensor	KEYWORD3
MagnetometerSensor	KEYWORD3
Mic	KEYWORD3
MusicPlayer	KEYWORD3
Notification	KEYWORD3
OneSheeld	KEYWORD3
OrientationSensor	KEYWORD3
Phone	KEYWORD3
PressureSensor	KEYWORD3
ProximitySensor	KEYWORD3
PushButton	KEYWORD3
SevenSegment	KEYWORD3
Skype	KEYWORD3
Slider	KEYWORD3
SMS	KEYWORD3
TemperatureSensor	KEYWORD3
ToggleButton	KEYWORD3
Twitter	KEYWORD3
Clock	KEYWORD3
PulseWidthModulation	KEYWORD3
AsciiKeyboard	KEYWORD3
TextToSpeech	KEYWORD3
VoiceRecognition	KEYWORD3
Logger	KEYWORD3
Terminal	KEYWORD3
Pattern	KEYWORD3
Internet	KEYWORD3
JsonKeyChain	KEYWORD3
#######################################
# Methods and Functions (KEYWORD2)
#######################################
open	KEYWORD2
getX	KEYWORD2
getY	KEYWORD2
getZ	KEYWORD2
buzzOn	KEYWORD2
buzzOff	KEYWORD2
begin	KEYWORD2
rearCapture	KEYWORD2
setFlash	KEYWORD2
send	KEYWORD2
post	KEYWORD2
postLastPicutre	KEYWORD2
setLow	KEYWORD2
setHigh	KEYWORD2
setValue	KEYWORD2
checkIn	KEYWORD2
isUpPressed	KEYWORD2
isDownPressed	KEYWORD2
isLeftPressed	KEYWORD2
isRightPressed	KEYWORD2
isOrangePressed	KEYWORD2
isRedPressed	KEYWORD2
isGreenPressed	KEYWORD2
isBluePressed	KEYWORD2
getLatitude	KEYWORD2
getLongitude	KEYOWRD2
init	KEYWORD2
isRowPressed	KEYWORD2
isColumnPressed	KEYWROD2
setOnButtonChange	KEYWORD2
clear	KEYWORD2
home	KEYWORD2
noDisplay	KEYWORD2
display	KEYWORD2
noBlink	KEYWORD2
blink	KEYWORD2
noCursor	KEYWORD2
cursor	KEYWORD2
scrollDisplayLeft	KEYWORD2
scrollDisplayRight	KEYWORD2
leftToRight	KEYWORD2
rightToLeft	KEYWORD2
autoScroll	KEYWORD2
noAutoScroll	KEYWORD2
createChar	KEYWORD2
setCursor	KEYWORD2
getValue	KEYWORD2
stop	KEYWORD2
play	KEYWORD2
pause	KEYWORD2
previous	KEYWORD2
next	KEYWORD2
seekForward	KEYWORD2
seekBackward	KEYWORD2
notifyPhone	KEYWORD2
call	KEYWORD2
setNumber	KEYWORD2
videoCall	KEYWORD2
message	KEYWORD2
isInRange	KEYWORD2
getDistance	KEYWORD2
radian	KEYWORD2
isRinging	KEYWORD2
getNumber	KEYWORD2
getNumberAsString	KEYWORD2
getSms	KEYWORD2
getSmsAsString	KEYWORD2
isNewSms	KEYWORD2
frontCapture	KEYWORD2
getSeconds	KEYWORD2
getMinutes	KEYWORD2
getHours	KEYWORD2
getDay	KEYWORD2
getMonth	KEYWORD2
getYear	KEYWORD2
setVolume	KEYWORD2
isAnyRowPressed	KEYWORD2
isAnyColumnPressed	KEYWORD2
getCharacter	KEYWORD2
setOnValueChange	KEYWORD2
setQuality	KEYWORD2
getMagneticStrength	KEYWORD2
setOnCallStatusChange	KEYWORD2
setOnSmsReceive	KEYWORD2
setOnButtonStatusChange	KEYWORD2
sendMessage	KEYWORD2
isPressed	KEYWORD2
getUserName	KEYWORD2
getTweet	KEYWORD2
getTweetAsString	KEYWORD2
isNewTweet	KEYWORD2
getUserNameAsString	KEYWORD2
setDot	KEYWORD2
tweet	KEYWORD2
setOnNewTweet	KEYWORD2
getAsFahrenheit	KEYWORD2
say	KEYWORD2
startListening	KEYWORD2
getLastCommand	KEYWORD2
getCommandAsString	KEYWORD2
isNewCommandReceived	KEYWORD2
setOnNewCommand	KEYWORD2
log	KEYWORD2
setFileFormat	KEYWORD2
add	KEYWORD2
postPicture	KEYWORD2
postLastPicture	KEYWORD2
setOnError	KEYWORD2
start	KEYWORD2
getStatus	KEYOWRD2
getLastCommandLength	KEYWORD2
tweetLastPicture	KEYWORD2
setOnSelected	KEYWORD2
select	KEYWORD2
deselect	KEYWORD2
waitForAppConnection	KEYWORD2
setOnSelected	KEYWORD2
attachLastPicture	KEYWORD2
isAppConnected	KEYWORD2
trackKeyword	KEYWORD2
untrackKeyword	KEYWORD2
listenToRemoteOneSheeld	KEYWORD2
setOnNewMessage	KEYWORD2
setOnSubscribeOrDigitalChange	KEYWORD2
subscribeToChanges	KEYWORD2
unsubscribeToChanges	KEYWORD2
getOnButtonStatusChange	KEYWORD2
getLasPattern	KEYWORD2
isNewPatternReceived	KEYWORD2
setOnNewPattern	KEYWORD2
getRow	KEYWORD2
getColumn	KEYWORD2
HttpRequest	KEYWORD2
setUrl	KEYWORD2
addHeader	KEYWORD2
addParameters	KEYWORD2
addRawData	KEYWORD2
getId	KEYWORD2
deleteHeaders	KEYWORD2
deleteParameters	KEYWORD2
deleteCallBacks	KEYWORD2
setContentTypes	KEYWORD2
setParametersContentEncoding	KEYWORD2
ignoreResponse	KEYWORD2
isStarted	KEYWORD2
isFinished	KEYWORD2
setOnSuccess	KEYWORD2
setOnFailure	KEYWORD2
setOnStart	KEYWORD2
setOnFinish	KEYWORD2
getResponse	KEYWORD2
HttpResponse	KEYWORD2
isSentFully						KEYWORD2
isDisposed						KEYWORD2
setOnNextResponseBytesUpdate	KEYWORD2
setOnJsonResponse	KEYWORD2
setOnJsonArrayLengthResponse	KEYWORD2
dispose	KEYWORD2
resetIndex	KEYWORD2
getNextBytes	KEYWORD2
getTheseBytes	KEYWORD2
getHeader	KEYWORD2
getStatusCode	KEYWORD2
getBytesCount	KEYWORD2
getTotalBytesCount	KEYWORD2
getCurrentIndex	KEYWORD2
getBytes	KEYWORD2
JsonKeyChain	KEYWORD2
query	KEYWORD2
queryArrayLength	KEYWORD2
performGet	KEYWORD2
performPost	KEYWORD2
performPut	KEYWORD2
performDelete	KEYWORD2
cancelAllRequests	KEYWORD2
setBasicAuthentication	KEYWORD2
clearBasicAuthentication	KEYWORD2
setIntialResponseMaxBytesCount	KEYWORD2
processInput	KEYWORD2
isCallbacksInterruptsSet	KEYWORD2
enableCallbacksInterrupts	KEYWORD2
disableCallbacksInterrupts	KEYWORD2
getShieldId	KEYWORD2
getLastPattern	KEYWORD2
getLastPatternSize	KEYWORD2
isNewPatternReceived	KEYWORD2
setOnNewPattern	KEYWORD2
getLastCommandAsString	KEYWORD2
RemoteOneSheeld	KEYWORD2
PatternNode	KEYWORD2
#######################################
# Constants And Literals (KEYWORD2)
#######################################
OFF	LITERAL1
AUTO	LITERAL1
ON	LITERAL1
RADUIS_OF_EARTH	LITERAL1
LOW_QUALITY	LITERAL1
MID_QUALITY	LITERAL1
HIGH_QUALITY	LITERAL1
NETWORK_TIMEOUT_ERROR	LITERAL1
NETWORK_ERROR	LITERAL1
AUDIO_ERROR	LITERAL1
SERVER_ERROR	LITERAL1
SPEECH_TIMEOUT_ERROR	LITERAL1
NO_MATCH_ERROR	LITERAL1
RECOGNIZER_BUSY_ERROR	LITERAL1
FROM_ONESHEELD_FOLDER	LITERAL1
FROM_CAMERA_FOLDER	LITERAL1
INDEX_OUT_OF_BOUNDS	LITERAL1					
RESPONSE_CAN_NOT_BE_FOUND	LITERAL1
HEADER_CAN_NOT_BE_FOUND	LITERAL1
NO_ENOUGH_BYTES	LITERAL1
REQUEST_HAS_NO_RESPONSE	LITERAL1
SIZE_OF_REQUEST_CAN_NOT_BE_ZERO	LITERAL1
UNSUPPORTED_HTTP_ENTITY	LITERAL1
JSON_KEYCHAIN_IS_WRONG	LITERAL1
REQUEST_CAN_NOT_BE_FOUND	LITERAL1
NOT_CONNECTED_TO_NETWORK	LITERAL1
URL_IS_NOT_FOUND	LITERAL1
ALREADY_EXECUTING_REQUEST	LITERAL1
URL_IS_WRONG	LITERAL1
